time - temps
year - année
people - gens
way - façon
day - jour
thing - chose
man - homme
world - monde
life - vie
hand - main
part - partie
child - enfant
eye - oeil
woman - femme
place - place
work - travail
week - semaine
case - cas
point - point
government - gouvernement
company - entreprise
number - nombre
group - groupe
problem - problème
fact - fait
money - argent
month - mois
lot - beaucoup
person - personne
end - fin
kind - type
head - tête
face - visage
interest - intérêt
course - cours
country - pays
book - livre
side - côté
idea - idée
family - famille
party - parti
system - système
war - guerre
history - histoire
state - état
night - nuit
line - ligne
police - police
water - eau
mind - esprit
father - père
power - puissance
room - pièce
mother - mère
area - zone
story - histoire
fact - fait
guy - gars
moment - moment
air - air
head - tête
war - guerre
south - sud
body - corps
radio - radio
reason - raison
community - communauté
price - prix
friend - ami
word - mot
boy - garçon
member - membre
name - nom
course - cours
morality - moralité
ability - capacité
music - musique
business - affaires
study - étude
situation - situation
force - force
law - loi
practice - pratique
thought - pensée
market - marché
death - mort
art - art
experience - expérience
century - siècle
perception - perception
pressure - pression
view - vue
spirit - esprit
risk - risque
teacher - professeur
mother - mère
mind - esprit
change - changement
heart - cœur
city - ville
school - école
father - père
sea - mer
level - niveau
space - espace
christianity - christianisme
meeting - réunion
navy - marine
image - image
information - information
concept - concept
love - amour
justice - justice
god - dieu
moment - moment
air - air
wife - femme
education - éducation
office - bureau
director - directeur
thought - pensée
science - science
region - région
health - santé
table - table
sense - sens
movement - mouvement
period - période
nature - nature
perception - perception
morning - matin
secretary - secrétaire
earth - terre
today - aujourd'hui
theory - théorie
conference - conférence
fire - feu
impact - impact
labor - travail
environment - environnement
technology - technologie
investment - investissement
treatment - traitement
tv - télé
attention - attention
daughter - fille
culture - culture
relationship - relation
future - futur
debate - débat
growth - croissance
employment - emploi
humor - humour
marriage - mariage
disease - maladie
speech - discours
instance - instance
nation - nation
leader - leader
foundation - fondation
development - développement
kitchen - cuisine
audience - public
climate - climat
writing - écriture
killing - meurtre
cancer - cancer
verdict - verdict
income - revenu
administration - administration
career - carrière
academy - académie
inflation - inflation
winner - gagnant
performance - performance
directory - annuaire
autumn - automne
economics - économie
communication - communication
production - production
measurement - mesure
tension - tension
category - catégorie
activity - activité
agency - agence
revenue - revenu
attitude - attitude
convention - convention
location - emplacement
challenge - défi
edition - édition
interaction - interaction
opportunity - opportunité
priority - priorité
foundation - fondation
emotion - émotion
epidemic - épidémie
physician - médecin
philosophy - philosophie
outcome - résultat
partner - partenaire
failure - échec
addition - addition
interaction - interaction
prize - prix
popularity - popularité
assistance - assistance
district - quartier
conflict - conflit
balance - équilibre
highway - autoroute
diagnosis - diagnostic
item - article
tone - ton