time - Zeit  
year - Jahr
people - Leute 
way - Weg
day - Tag
thing - Sache
man - Mann
world - Welt
life - Leben
hand - Hand
part - Teil
child - Kind
eye - Auge
woman - Frau 
place - Ort
work - Arbeit 
week - Woche
case - Fall
point - Punkt
government - Regierung
company - Firma  
number - Nummer
group - Gruppe
problem - Problem
fact - Fakt
money - Geld
month - Monat
lot - viel  
person - Person
end - Ende
kind - Art
head - Kopf 
face - Gesicht
interest - Interesse
course - Kurs
country - Land
book - Buch
side - Seite   
idea - Idee
family - Familie 
party - Partei  
system - System
war - Krieg
history - Geschichte
state - Staat  
night - Nacht
line - Linie 
police - Polizei
water - Wasser
mind - Verstand
father - Vater  
power - Macht 
room - Zimmer
mother - Mutter
area - Bereich 
story - Geschichte 
guy - Kerl  
moment - Moment
air - Luft
head - Kopf
war - Krieg 
south - Süden
body - Körper
radio - Radio    
reason - Grund
community - Gemeinschaft 
price - Preis 
friend - Freund
word - Wort
boy - Junge
member - Mitglied
name - Name
course - Kurs
morality - Moral
ability - Fähigkeit
music - Musik
business - Geschäft   
study - Studium  
situation - Situation  
force - Kraft
law - Gesetz  
practice - Praxis
thought - Gedanke
market - Markt
death - Tod
art - Kunst
experience - Erfahrung
century - Jahrhundert   
perception - Wahrnehmung  
pressure - Druck
view - Sicht  
spirit - Geist  
risk - Risiko
teacher - Lehrer
mother - Mutter
mind - Verstand
change - Wandel
heart - Herz  
city - Stadt   
school - Schule  
father - Vater   
sea - Meer  
level - Level
space - Raum   
christianity - Christentum
meeting - Treffen
navy - Marine   
image - Bild
information - Information
concept - Konzept  
love - Liebe  
justice - Gerechtigkeit
god - Gott
moment - Moment
air - Luft 
wife - Ehefrau
education - Bildung   
office - Büro  
director - Direktor 
thought - Gedanke
science - Wissenschaft    
region - Region
health - Gesundheit   
table - Tabelle  
sense - Sinn   
movement - Bewegung
period - Zeitraum 
nature - Natur   
perception - Wahrnehmung  
morning - Morgen  
secretary - Sekretär  
earth - Erde
today - heute   
theory - Theorie
conference - Konferenz 
fire - Feuer   
impact - Einfluss
labor - Arbeit  
environment - Umwelt  
technology - Technologie  
investment - Investition
treatment - Behandlung 
tv - Fernsehen  
attention - Aufmerksamkeit  
daughter - Tochter  
culture - Kultur   
relationship - Beziehung  
future - Zukunft  
debate - Debatte 
growth - Wachstum
employment - Beschäftigung   
humor - Humor
marriage - Ehe  
disease - Krankheit 
speech - Rede
instance - Beispiel
nation - Nation  
leader - Führer
foundation - Stiftung  
development - Entwicklung  
kitchen - Küche   
audience - Publikum   
climate - Klima  
writing - Schrift   
killing - Töten  
cancer - Krebs
verdict - Urteil  
income - Einkommen   
administration - Verwaltung  
career - Karriere   
academy - Akademie  
inflation - Inflation  
winner - Gewinner  
performance - Leistung
directory - Verzeichnis     
autumn - Herbst
economics - Wirtschaft
communication - Kommunikation
production - Produktion     
measurement - Messung
tension - Spannung  
category - Kategorie
activity - Aktivität
agency - Agentur    
revenue - Einnahme  
attitude - Einstellung
convention - Konvention  
location - Standort  
challenge - Herausforderung
edition - Ausgabe
interaction - Interaktion   
opportunity - Möglichkeit  
priority - Priorität    
foundation - Stiftung
emotion - Emotion  
epidemic - Epidemie  
physician - Arzt  
philosophy - Philosophie    
outcome - Ergebnis  
partner - Partner 
failure - Versagen  
addition - Zusatz
interaction - Interaktion
prize - Preis  
popularity - Beliebtheit
assistance - Hilfe
district - Bezirk
conflict - Konflikt
balance - Gleichgewicht
highway - Autobahn  
diagnosis - Diagnose
item - Artikel   
tone - Ton