time - tempo
year - anno  
people - persone
way - modo 
day - giorno
thing - cosa
man - uomo 
world - mondo
life - vita
hand - mano
part - parte
child - bambino
eye - occhio
woman - donna
place - posto 
work - lavoro
week - settimana
case - caso
point - punto  
government - governo
company - azienda
number - numero  
group - gruppo
problem - problema
fact - fatto
money - soldi
month - mese 
lot - molto
person - persona
end - fine
kind - tipo
head - testa
face - faccia  
interest - interesse  
course - corso
country - paese
book - libro
side - lato
idea - idea
family - famiglia
party - festa
system - sistema 
war - guerra
history - storia
state - stato
night - notte  
line - linea
police - polizia  
water - acqua
mind - mente
father - padre
power - potere  
room - stanza 
mother - madre
area - zona
story - storia 
guy - ragazzo
moment - momento 
air - aria
head - testa
war - guerra
south - sud
body - corpo 
radio - radio
reason - ragione 
community - comunità
price - prezzo  
friend - amico 
word - parola
boy - ragazzo
member - membro
name - nome  
course - corso 
morality - moralità
ability - capacità
music - musica
business - business 
study - studio
situation - situazione  
force - forza 
law - legge
practice - pratica
thought - pensiero  
market - mercato 
death - morte
art - arte
experience - esperienza  
century - secolo
perception - percezione  
pressure - pressione 
view - vista
spirit - spirito
risk - rischio 
teacher - insegnante   
mother - madre
mind - mente  
change - cambiamento
heart - cuore
city - città
school - scuola  
father - padre
sea - mare
level - livello 
space - spazio 
christianity - cristianesimo
meeting - incontro
navy - marina
image - immagine
information - informazione
concept - concetto  
love - amore  
justice - giustizia
god - dio 
moment - momento
air - aria
wife - moglie 
education - educazione
office - ufficio
director - direttore
thought - pensiero
science - scienza  
region - regione
health - salute
table - tavolo
sense - senso
movement - movimento  
period - periodo
nature - natura  
perception - percezione
morning - mattina 
secretary - segretaria  
earth - terra
today - oggi  
theory - teoria
conference - conferenza
fire - fuoco    
impact - impatto 
labor - lavoro 
environment - ambiente
technology - tecnologia  
investment - investimento  
treatment - trattamento
tv - televisione
attention - attenzione  
daughter - figlia  
culture - cultura  
relationship - rapporto
future - futuro  
debate - dibattito
growth - crescita
employment - occupazione  
humor - umorismo
marriage - matrimonio 
disease - malattia
speech - discorso
instance - esempio  
nation - nazione
leader - leader
foundation - fondazione
development - sviluppo
kitchen - cucina   
audience - pubblico 
climate - clima  
writing - scrittura  
killing - uccisione 
cancer - cancro  
verdict - verdetto  
income - reddito
administration - amministrazione  
career - carriera
academy - accademia  
inflation - inflazione 
winner - vincitore
performance - prestazione   
directory - elenco  
autumn - autunno  
economics - economia
communication - comunicazione
production - produzione    
measurement - misura  
tension - tensione 
category - categoria
activity - attività  
agency - agenzia 
revenue - entrate 
attitude - atteggiamento  
convention - convenzione  
location - posizione 
challenge - sfida  
edition - edizione
interaction - interazione  
opportunity - opportunità  
priority - priorità    
foundation - fondazione
emotion - emozione  
epidemic - epidemia
physician - medico
philosophy - filosofia  
outcome - risultato 
partner - partner
failure - fallimento
addition - aggiunta
interaction - interazione 
prize - premio
popularity - popolarità  
assistance - assistenza  
district - distretto  
conflict - conflitto
balance - bilancio  
highway - autostrada   
diagnosis - diagnosi 
item - elemento
tone - tono
